259 259 259 259 259 259 259 259 259 259 259 0 0 0 0 0 0 0 0 0 0 0 0 0 0 0 0 0 0 0 0 0 0 0 0 0 0 23 23 23 23 23 0 0 0 
259 259 259 259 259 259 259 259 259 0 0 0 0 0 0 0 0 0 0 0 0 0 0 0 0 0 0 0 0 0 0 0 0 0 0 0 0 23 23 23 23 23 23 0 0
259 259 259 259 259 259 259 259 0 0 0 0 0 446 446 446 446 0 0 0 0 0 0 0 0 0 0 0 0 0 0 0 0 0 0 0 0 0 34 34 23 23 23 23 0 
259 259 259 259 259 259 259 259 0 0 0 0 0 446 446 446 0 0 0 0 0 0 0 0 0 0 0 0 0 0 0 0 0 0 0 0 0 0 0 34 34 196 23 23 0
259 259 259 259 259 259 259 0 0 0 0 0 0 446 446 0 0 0 0 0 0 0 0 0 0 0 0 0 446 446 446 442 442 446 446 0 0 0 0 0 34 34 23 23 0 
259 259 259 0 0 259 259 259 0 0 0 0 446 446 446 0 0 0 0 0 0 0 0 0 0 0 446 446 446 446 446 446 446 446 446 446 446 0 0 0 0 34 34 23 23
259 259 0 0 0 0 259 259 0 0 0 0 446 446 446 0 0 0 0 0 0 0 0 446 446 446 442 446 446 446 442 446 446 442 446 442 446 446 0 0 0 0 34 34 23 
259 259 0 0 0 0 259 259 259 0 0 0 446 446 0 0 0 0 0 0 0 0 446 446 446 442 446 446 446 446 446 446 446 446 446 442 442 446 446 0 0 0 0 0 23
259 0 0 0 0 0 0 0 0 0 0 0 0 0 0 0 0 0 0 0 0 0 446 446 0 446 446 446 0 0 0 0 0 0 446 446 446 442 442 446 0 0 0 0 23 
259 0 0 0 0 0 0 0 0 0 0 0 0 0 0 0 0 0 0 0 0 0 446 446 446 446 446 0 0 0 0 0 0 0 0 0 446 446 442 446 446 0 0 0 23
0 0 0 0 0 0 0 0 0 0 0 0 0 0 0 0 0 0 0 0 442 442 442 446 446 446 0 0 0 282 282 0 0 0 282 282 0 446 442 442 446 446 0 0 0 
0 0 0 0 0 0 0 0 0 0 0 0 0 0 0 0 0 0 0 0 442 442 446 442 446 446 0 0 282 282 282 110 203 203 282 282 0 0 446 446 446 446 0 0 0
0 0 0 0 0 0 0 0 0 0 0 0 0 0 0 0 0 0 0 0 446 442 446 446 446 0 0 282 282 282 253 110 110 203 203 282 282 0 0 0 446 446 0 0 0 
240 240 240 240 240 0 0 0 0 0 0 0 0 0 0 0 0 0 0 0 0 446 442 446 446 0 282 282 282 203 66 66 110 110 110 282 282 282 0 446 442 446 0 0 0
239 239 239 239 239 240 240 240 0 0 0 0 0 0 0 0 0 0 0 0 0 446 442 446 446 0 282 282 282 66 45 66 283 110 203 282 282 282 0 446 442 446 446 0 0 
239 239 239 239 383 383 239 240 240 0 0 0 0 0 0 0 0 0 0 0 0 446 446 446 446 0 282 282 282 203 66 110 110 66 203 282 282 282 0 446 446 446 446 0 0
235 235 235 239 239 383 383 383 383 240 240 240 240 0 0 0 0 0 0 0 0 446 442 446 446 446 0 282 282 282 203 110 45 66 203 282 282 0 0 446 446 446 0 0 0 
235 235 235 235 235 239 239 239 383 239 239 239 240 240 240 240 0 0 0 0 0 0 446 442 446 446 0 0 282 282 203 45 45 203 282 282 282 0 0 446 446 446 446 0 0
236 236 236 235 235 235 235 235 235 235 239 383 239 239 239 240 240 240 0 0 0 0 446 446 446 446 0 0 282 282 0 203 203 203 282 0 0 0 0 446 446 442 446 0 0 
236 236 236 236 236 235 235 235 235 235 235 235 239 239 383 239 240 240 240 240 0 0 446 446 446 446 446 0 0 0 0 276 277 0 0 0 0 0 442 446 446 446 446 0 0
236 236 236 236 236 236 236 236 235 235 235 235 235 235 239 383 383 383 240 240 240 0 0 446 446 442 446 0 0 0 0 279 280 0 0 0 0 0 446 442 446 0 0 0 461 
236 236 236 236 236 236 236 236 236 236 236 235 235 235 235 235 235 239 239 239 240 240 240 0 446 446 442 0 0 0 0 0 0 0 0 0 0 0 446 442 0 0 0 461 461
236 236 236 236 236 236 236 236 236 236 236 236 236 235 235 235 235 235 235 235 239 239 240 240 0 0 0 0 0 0 0 0 0 0 0 0 0 0 0 0 0 0 461 461 461 
236 236 236 236 236 236 236 236 236 236 236 236 236 236 236 236 235 235 235 235 235 235 235 240 240 240 240 0 0 0 0 0 0 0 0 0 0 0 0 0 461 461 461 461 461 
236 236 236 236 236 236 236 236 236 236 236 236 236 236 236 236 236 236 236 235 235 235 235 239 239 239 240 240 0 0 0 0 0 0 0 0 0 0 0 461 461 461 461 461 461