0 0 0 0 0 0 0 0 0 0 0 0 0 0 0 0 0 0 0 0 0 0 0 0 0 1036 1036 1036 1036 1036 0 1036 1036 0 0 0 0 0 0 0 0 0 0 0 0 0 0 0 0 0 
0 0 0 0 0 0 0 0 0 0 0 0 0 0 0 0 0 0 0 0 1036 1036 1036 1036 0 0 0 0 0 0 0 0 1036 1036 1036 1036 0 0 0 0 0 0 0 0 0 0 0 0 0 0 
0 0 0 0 0 0 0 0 0 0 0 0 0 0 0 0 1036 1036 1036 0 0 0 0 0 0 0 0 0 0 0 0 0 0 0 0 0 1036 1036 0 0 0 0 0 0 0 0 0 0 0 0 
0 0 0 0 0 0 0 0 0 0 0 0 0 0 1036 1036 0 0 0 0 0 0 0 0 0 0 0 0 0 0 0 0 0 0 0 0 0 0 1036 1036 1036 0 0 0 0 0 0 0 0 0 
0 0 0 0 0 0 0 0 0 0 0 1036 1036 1036 0 0 0 0 0 0 0 0 0 0 0 0 0 0 0 0 0 0 0 0 0 0 0 0 0 0 1036 1036 1036 0 0 0 0 0 0 0 
0 0 0 0 0 0 0 0 0 0 1036 1036 0 0 0 0 0 0 0 0 0 0 0 0 0 0 0 0 0 0 0 0 0 0 0 0 0 0 0 0 0 0 0 1036 0 0 0 0 0 0 
0 0 0 0 0 0 0 0 0 1036 1036 0 0 0 591 591 591 591 0 0 0 0 0 0 0 0 0 0 0 0 0 0 0 0 0 0 0 0 0 0 0 0 0 1036 0 0 0 0 0 0 
0 0 0 0 0 0 0 0 1036 1036 0 591 591 591 0 0 0 591 591 0 0 0 0 0 0 0 0 0 0 0 0 591 591 591 591 0 0 0 0 0 0 0 0 0 1036 0 0 0 0 0 
0 0 0 0 0 0 0 0 1036 591 591 0 0 0 0 0 0 0 591 0 0 0 0 0 0 0 0 0 591 591 591 0 0 0 0 0 0 0 0 0 0 0 0 0 1036 0 0 0 0 0 
0 0 0 0 0 0 0 591 591 0 0 0 0 0 0 0 0 0 0 591 0 718 718 718 591 718 591 0 718 0 0 0 0 0 0 0 0 0 0 0 0 0 0 0 1036 0 0 0 0 0 
0 0 0 0 0 0 0 1036 0 0 0 0 0 0 0 0 0 0 718 591 718 591 591 0 0 0 0 0 0 718 718 718 718 0 0 0 0 0 0 0 0 0 0 0 1036 0 0 0 0 0 
0 0 0 0 591 591 0 1036 0 0 0 0 0 0 0 0 591 718 591 591 0 0 0 0 0 0 0 0 0 0 0 0 0 718 718 0 0 0 0 0 0 0 0 0 1036 0 0 0 0 0 
0 0 0 591 0 0 0 1036 0 0 0 0 591 591 591 591 718 0 0 0 0 0 0 0 0 0 0 0 0 0 0 0 0 0 0 718 0 0 0 0 0 0 0 0 1036 0 0 0 0 0 
0 0 0 0 0 0 0 1036 0 591 591 0 0 0 0 0 718 0 591 0 0 0 0 0 0 0 0 0 0 0 0 0 0 0 0 718 718 0 0 0 0 0 0 0 1036 0 0 0 0 0 
0 0 591 0 0 0 0 1036 591 591 0 0 0 0 0 718 0 0 591 0 0 0 0 0 0 0 0 0 0 0 0 0 0 0 0 0 718 0 0 0 0 0 0 0 0 0 0 0 0 0 
0 591 0 0 0 0 0 0 591 591 0 0 0 0 0 718 0 591 0 0 0 0 0 0 0 0 0 0 0 0 0 0 0 0 0 0 0 0 0 0 0 0 0 0 1036 0 0 0 0 0 
591 0 0 0 0 0 0 0 1036 591 0 0 0 0 0 718 0 0 0 0 0 0 0 0 0 0 0 0 0 0 0 0 0 0 0 718 0 0 0 0 0 0 0 1036 0 0 0 0 0 0 
591 0 0 0 0 0 0 0 0 591 591 0 0 0 0 718 0 591 0 0 0 0 0 0 0 0 0 0 0 0 0 0 0 0 718 0 0 0 0 0 0 0 0 1036 0 0 0 0 0 0 
591 0 0 0 0 0 0 0 0 0 1036 591 0 0 0 718 591 0 0 0 0 0 0 0 0 0 0 0 0 0 0 0 0 718 0 0 0 0 0 0 0 0 0 1036 0 0 0 0 0 0 
591 0 0 0 0 0 0 0 0 0 0 591 591 1036 1036 0 718 0 0 0 0 0 0 0 0 0 0 0 0 0 0 0 0 718 0 0 0 0 0 0 0 0 1036 0 0 0 0 0 0 0 
591 0 0 0 0 0 0 0 0 0 0 0 591 0 1036 0 591 718 718 0 0 0 0 0 0 0 0 0 0 0 718 0 718 0 0 0 0 0 0 0 0 0 1036 0 0 0 0 0 0 0 
591 0 0 0 0 0 0 0 0 0 0 0 591 591 0 0 591 0 0 718 718 718 718 718 718 718 718 718 718 718 0 0 0 0 0 0 0 0 0 0 0 1036 0 0 0 0 0 0 0 0 
591 591 591 591 591 0 0 0 0 0 0 0 591 0 0 0 0 0 0 0 0 0 0 0 718 718 718 718 718 0 0 0 0 0 0 0 0 0 0 0 1036 1036 0 0 0 0 0 0 0 0 
0 0 0 0 0 591 591 591 591 591 591 591 0 0 0 0 0 591 0 0 0 0 0 0 0 0 0 0 0 0 0 0 0 0 0 0 0 0 1036 1036 0 0 0 0 0 0 0 0 0 0 
0 0 0 0 0 0 0 0 0 0 0 0 0 0 0 0 0 591 591 591 0 0 0 0 0 0 0 0 0 0 0 0 0 0 0 591 0 0 0 0 0 0 0 0 0 0 0 0 0 0 
0 0 0 0 0 0 0 0 0 0 0 0 0 0 0 0 0 0 0 0 591 0 591 0 591 591 591 591 591 0 591 591 591 591 591 0 0 0 0 0 0 0 0 0 0 0 0 0 0 0 
0 0 0 0 0 0 0 0 0 0 0 0 0 0 0 0 0 0 0 0 0 0 0 0 0 0 0 0 0 0 0 0 0 0 0 0 0 0 0 0 0 0 0 0 0 0 0 0 0 0 
0 0 0 0 0 0 0 0 0 0 0 0 0 0 0 0 0 0 0 0 0 0 0 0 0 0 0 0 0 0 0 0 0 0 0 0 0 0 0 0 0 0 0 0 0 0 0 0 0 0 
