986 986 0 0 0 0 0 0 0 0 0 0 0 0 0 0 0 0 0 0 0 0 0 0 0 1036 1036 1036 1036 1036 0 1036 1036 0 0 0 0 0 0 0 0 0 0 0 0 0 0 0 0 0 
0 0 0 0 0 0 0 0 986 986 986 986 0 0 296 296 296 296 296 296 296 1036 1036 1036 0 0 0 0 0 0 0 0 1036 1036 1036 1036 0 0 0 0 0 986 986 0 986 986 0 0 0 0 
0 0 0 0 986 0 986 0 0 0 0 0 0 0 0 0 1036 1036 1036 0 0 0 849 0 0 0 0 0 0 0 0 0 0 0 0 0 1036 1036 0 0 0 0 0 0 0 0 0 986 986 0 
0 0 0 0 0 0 0 0 0 296 296 296 0 296 1036 1036 0 986 0 849 849 0 849 0 0 0 0 0 0 849 849 849 0 0 0 0 0 0 0 0 0 0 0 0 296 296 0 0 986 0 
0 0 849 849 0 0 0 0 0 296 0 1036 1036 1036 0 0 0 0 0 0 849 849 849 0 0 0 0 0 0 0 0 0 849 849 0 0 0 0 0 0 0 0 1036 0 0 296 0 0 986 0 
0 0 849 0 0 0 0 0 0 296 1036 1036 0 0 0 0 0 0 0 0 0 0 0 0 0 296 296 296 296 0 0 0 0 0 849 849 0 0 0 0 0 0 0 1036 0 0 0 986 986 986 
986 0 0 849 0 0 0 0 0 296 1036 0 0 0 591 591 591 591 0 0 0 0 0 0 0 296 0 0 296 0 0 0 0 0 0 849 0 0 0 0 0 0 0 0 0 0 0 0 0 986 
986 0 0 849 0 0 0 0 1036 296 296 591 591 591 0 0 0 591 591 0 0 0 0 0 296 296 0 0 296 0 0 591 296 296 296 0 0 0 0 0 0 0 0 0 1036 0 0 0 0 986 
986 0 0 849 0 0 0 0 1036 591 296 0 0 0 0 0 0 0 591 0 0 0 0 0 0 0 0 0 296 591 591 0 0 0 849 849 0 0 0 0 0 0 0 0 1036 296 0 0 0 0 
986 0 0 849 0 0 0 591 591 0 0 0 0 0 0 0 0 0 0 591 0 718 718 718 591 718 591 296 296 0 0 0 0 0 0 849 0 0 0 0 0 296 0 0 1036 296 0 986 0 0 
0 0 0 849 0 0 0 1036 0 0 0 0 0 0 0 0 0 0 718 591 718 986 591 0 0 0 0 0 0 718 718 718 718 0 0 0 849 484 484 0 0 296 296 0 1036 0 0 986 0 0 
0 0 0 0 591 591 0 1036 0 0 0 0 0 0 0 0 591 718 591 591 0 0 986 0 0 296 296 296 0 0 0 0 0 718 718 0 0 849 484 484 849 849 849 849 849 849 0 0 0 0 
986 0 0 591 0 0 0 1036 0 0 0 0 591 591 591 591 718 0 0 0 0 0 986 986 296 296 296 296 296 0 0 0 0 0 0 718 0 849 0 0 849 849 849 0 1036 0 0 0 0 0 
986 0 0 0 0 0 0 1036 0 591 591 0 0 0 0 0 718 0 591 0 0 849 0 986 986 296 0 0 0 0 924 924 924 924 924 924 296 296 296 0 0 0 0 849 849 0 0 849 0 0 
0 0 591 0 0 0 0 1036 849 849 0 0 0 0 0 718 0 0 591 0 0 849 0 0 0 986 0 0 0 0 0 924 924 0 0 0 718 0 296 296 296 296 0 849 849 0 0 849 849 0 
0 591 0 0 0 0 0 849 849 591 0 0 0 0 0 718 0 591 0 0 0 849 849 0 0 986 986 0 296 296 0 0 0 924 0 0 0 0 0 0 0 0 0 0 1036 0 0 0 849 0 
591 0 0 0 0 0 849 0 1036 591 0 0 0 0 0 718 0 0 0 0 0 0 849 849 0 0 0 0 0 0 296 296 296 296 0 718 0 0 0 0 0 0 296 1036 0 0 0 0 0 0 
591 0 0 296 849 849 0 0 0 591 591 0 0 0 0 718 0 591 0 0 0 0 0 0 849 0 0 0 0 0 0 0 0 0 718 986 986 986 986 986 986 0 296 296 296 0 0 0 986 986 
591 0 0 296 849 0 0 0 0 0 1036 591 0 0 0 718 591 0 0 0 0 0 0 0 0 0 0 0 0 0 0 0 0 718 0 0 0 0 0 0 0 0 0 1036 296 986 0 0 986 0 
591 0 0 296 0 0 0 0 0 0 0 591 591 1036 1036 0 718 0 0 0 0 0 0 0 0 0 0 0 0 0 0 0 0 718 0 0 0 0 0 0 0 0 1036 0 0 296 0 0 0 0 
591 0 0 296 0 0 0 0 0 0 0 0 591 0 296 0 591 718 718 0 0 0 0 0 0 0 0 0 0 0 718 0 718 0 0 0 0 0 0 0 0 0 1036 0 0 0 296 0 0 0 
591 0 0 296 296 296 0 0 0 0 0 0 296 296 296 0 591 924 924 924 718 718 718 718 718 718 718 718 718 718 0 0 0 0 849 849 849 849 849 0 0 1036 0 0 0 0 296 0 0 0 
591 591 591 591 591 0 296 296 296 296 296 296 296 0 0 924 924 924 0 0 0 0 0 0 718 718 718 718 718 0 0 0 0 0 0 0 0 0 0 0 1036 1036 0 0 0 0 296 0 0 0 
0 0 0 986 0 591 591 591 591 591 591 591 0 924 924 924 0 591 0 0 0 0 0 0 0 0 0 0 0 0 0 0 0 296 296 296 296 296 0 1036 0 0 0 0 0 296 296 986 986 0 
0 0 0 986 986 0 0 0 0 0 0 924 924 0 0 0 0 591 591 591 0 0 0 0 0 0 0 0 0 0 0 0 296 296 0 591 0 0 296 0 0 0 0 0 0 296 0 986 0 0 
0 0 0 0 0 0 0 986 986 849 0 0 849 0 0 0 0 0 0 0 591 0 591 0 591 591 849 849 849 0 591 591 591 591 591 0 0 0 296 296 0 0 0 0 296 296 986 986 0 986 
0 0 0 0 0 0 0 0 986 986 986 849 849 0 0 986 986 986 986 986 849 986 849 849 849 849 849 0 0 0 0 0 0 0 0 0 0 0 0 296 296 0 0 0 296 0 0 0 0 0 
0 924 924 924 924 0 0 0 0 0 0 0 0 0 0 0 0 0 0 0 0 986 986 986 0 0 986 986 986 0 0 0 0 986 986 986 986 986 0 0 296 296 0 0 0 0 0 0 986 0 
